    dates: dates[text]
    selection: selection[text]
    Identifiant: identifiant[text]
    Titre: titre_fr[text]
    Description: description_fr[text]
    Description longue: description_longue_fr[text]
    Détail des conditions: detail_des_conditions_fr[text]
    Description longue - HTML: description_longue_html_fr[text]
    Type d’animation: type_d_animation[text]
    Mots clés: mots_cles_fr[text]
    Image: image[text]
    Aperçu: apercu[text]
    Image source: image_source[text]
    Dernière mise à jour: derniere_mise_a_jour[datetime]
    Résumé horaires: resume_horaires_fr[text]
    Horaires détaillés: horaires_detailles_fr[text]
    Résumé dates: resume_dates_fr[text]
    Thématiques: thematiques[text]
    Publics concernés: publics_concernes[text]
    Lien d’inscription: lien_d_inscription[text]
    Accessibilité: accessibilite_fr[text]
    Age minimum: age_minimum[int]
    Age maximum: age_maximum[int]
    En Une: en_une[text]
    Statut: statut[text]
    Lien: lien[text]
    Identifiant du lieu: identifiant_du_lieu[text]
    Nom du lieu: nom_du_lieu[text]
    Adresse: adresse[text]
    Code postal: code_postal[text]
    Ville: ville[text]
    Arrondissement: arrondissement[text]
    Département: departement[text]
    Région: region[text]
    Pays: pays[text]
    Image du lieu: image_du_lieu[text]
    Téléphone du lieu: telephone_du_lieu[text]
    Site web du lieu: site_web_du_lieu[text]
    Tags du lieu: tags_du_lieu[text]
    Description du lieu: description_du_lieu_fr[text]
    Liens du lieu: liens_du_lieu[text]
    Accès / Itinéraire: acces_itineraire_fr[text]
    animateurs: animateurs[text]
    organisateur: organisateur[text]
    partenaire: partenaire[text]
    geolocalisation: geolocalisation[geo_point_2d]
    Horaires ISO: horaires_iso[text]
    Evénements liés: evenements_lies[text]
    Crédits image: credits_image[text]
    Création de la fiche: creation_de_la_fiche[datetime]
    Dernière date: derniere_date[date]
    Dernière ouverture: derniere_ouverture[text]
    Dernière fermeture: derniere_fermeture[text]
    Orientation et axes transversaux: orientation_et_axes_transversaux[text]
    Inscription nécessaire ?: inscription_necessaire[text]
    Public spécifique: public_specifique[text]
    Reconduction: reconduction[text]
    Agenda d’origine ( titre ): agenda_d_origine_titre[text]
    Agenda d’origine ( uid ): agenda_d_origine_uid[text]
    Crédits de l’image du lieu: credits_de_l_image_du_lieu[text]
    Résumé horaires - DE: resume_horaires_de[text]
    referentscientifique: referentscientifique[text]
    unitesrecherche: unitesrecherche[text]
    CR: cr[text]
    date_debut: date_debut[text]
    date_debut_jour: date_debut_jour[text]
    date_debut_mois: date_debut_mois[text]
    date_fin: date_fin[text]
    date_fin_jour: date_fin_jour[text]
    date_fin_mois: date_fin_mois[text]
    tranche: tranche[text]
    nb_evenements: nb_evenements[text]
    lien_canonique: lien_canonique[text]
